{
"levels":[
        {
         "tiles":[
                     [8, 9, 9, 9, 9, 9, 9, 9, 9, 10, 9, 9, 10, 9, 9, 9, 9, 9, 9, 4],
                     [6, 12, 12, 12, 12, 12, 12, 12, 12, 6, 12, 12, 6, 12, 12, 12, 12, 12, 12, 6],
                     [6, 5, 5, 5, 5, 5, 7, 5, 5, 6, 5, 7, 6, 5, 5, 7, 5, 5, 5, 6],
                     [6, 5, 7, 5, 5, 5, 5, 5, 5, 6, 5, 7, 6, 5, 5, 5, 5, 7, 5, 6],
                     [6, 5, 5, 5, 5, 5, 7, 5, 7, 6, 7, 5, 6, 5, 5, 5, 5, 5, 5, 6],
                     [6, 5, 5, 5, 5, 5, 5, 5, 5, 6, 5, 5, 6, 9, 9, 9, 9, 9, 9, 6],
                     [6, 9, 9, 13, 5, 7, 3, 9, 9, 1, 5, 5, 6, 12, 12, 12, 12, 12, 12, 6],
                     [6, 12, 12, 12, 5, 5, 12, 12, 12, 12, 5, 5, 6, 5, 5, 5, 5, 7, 5, 6],
                     [6, 5, 5, 7, 5, 7, 5, 5, 5, 5, 5, 5, 6, 7, 5, 5, 5, 5, 7, 6],
                     [6, 5, 5, 5, 5, 7, 5, 5, 5, 5, 5, 5, 2, 5, 5, 5, 5, 5, 5, 6],
                     [6, 5, 5, 7, 5, 5, 5, 5, 5, 5, 7, 5, 7, 5, 5, 5, 5, 5, 5, 6],
                     [6, 5, 7, 5, 5, 5, 5, 5, 5, 5, 5, 5, 5, 5, 5, 5, 5, 5, 5, 6],
                     [6, 5, 5, 5, 5, 5, 5, 7, 5, 5, 7, 5, 0, 5, 5, 5, 5, 7, 5, 6],
                     [6, 5, 5, 5, 5, 5, 5, 5, 5, 5, 5, 5, 6, 5, 7, 5, 5, 5, 5, 6],
                     [11, 9, 9, 9, 9, 9, 9, 9, 9, 9, 9, 9, 10, 9, 9, 9, 9, 9, 9, 1]
         ]
        },
        {
          "tiles":[
            [8, 9, 9, 9, 9, 9, 9, 9, 9, 10, 9, 9, 10, 9, 9, 9, 9, 9, 9, 4],
            [6, 12, 12, 12, 12, 12, 12, 12, 12, 6, 12, 12, 6, 12, 12, 12, 12, 12, 12, 6],
            [6, 5, 5, 5, 5, 5, 7, 5, 5, 6, 5, 7, 6, 5, 5, 7, 5, 5, 5, 6],
            [6, 5, 7, 5, 5, 5, 5, 5, 5, 6, 5, 7, 6, 5, 5, 5, 5, 7, 5, 6],
            [6, 5, 5, 5, 5, 5, 7, 5, 7, 6, 7, 5, 6, 5, 5, 5, 5, 5, 5, 6],
            [6, 5, 5, 5, 5, 5, 5, 5, 5, 6, 5, 5, 6, 9, 9, 9, 9, 9, 9, 6],
            [6, 9, 9, 13, 5, 7, 3, 9, 9, 1, 5, 5, 6, 12, 12, 12, 12, 12, 12, 6],
            [6, 12, 12, 12, 5, 5, 12, 12, 12, 12, 5, 5, 6, 5, 5, 5, 5, 7, 5, 6],
            [6, 5, 5, 7, 5, 7, 5, 5, 5, 5, 5, 5, 6, 7, 5, 5, 5, 5, 7, 6],
            [6, 5, 5, 5, 5, 7, 5, 5, 5, 5, 5, 5, 2, 5, 5, 5, 5, 5, 5, 6],
            [6, 5, 5, 7, 5, 5, 5, 5, 5, 5, 7, 5, 7, 5, 5, 5, 5, 5, 5, 6],
            [6, 5, 7, 5, 5, 5, 5, 5, 5, 5, 5, 5, 5, 5, 5, 5, 5, 5, 5, 6],
            [6, 5, 5, 5, 5, 5, 5, 7, 5, 5, 7, 5, 0, 5, 5, 5, 5, 7, 5, 6],
            [6, 5, 5, 5, 5, 5, 5, 5, 5, 5, 5, 5, 6, 5, 7, 5, 5, 5, 5, 6],
            [11, 9, 9, 9, 9, 9, 9, 9, 9, 9, 9, 9, 10, 9, 9, 9, 9, 9, 9, 1]
          ]
        }
]
}