{
"levels":[
        {
         "tiles":[
           [8, 9, 9, 9, 9, 18, 19, 9, 9, 9, 9, 10, 9, 9, 9, 9, 9, 9, 9, 4],
           [6, 12, 12, 12, 12, 20, 21, 12, 12, 12, 12, 6, 12, 12, 12, 12, 12, 12, 12, 6],
           [6, 7, 5, 5, 5, 5, 5, 5, 5, 5, 7, 6, 5, 7, 7, 5, 7, 5, 5, 6],
           [6, 5, 5, 5, 7, 5, 5, 5, 7, 5, 5, 6, 5, 5, 5, 5, 5, 7, 5, 6],
           [6, 5, 7, 7, 7, 5, 5, 5, 5, 7, 5, 6, 5, 5, 7, 5, 5, 7, 7, 6],
           [6, 5, 5, 5, 5, 5, 7, 5, 5, 7, 5, 6, 7, 5, 5, 5, 5, 5, 5, 6],
           [6, 9, 9, 9, 13, 18, 19, 3, 9, 9, 9, 9, 9, 9, 13, 14, 15, 3, 9, 6],
           [6, 12, 12, 12, 12, 20, 21, 12, 12, 12, 12, 12, 12, 12, 12, 16, 17, 12, 12, 6],
           [6, 5, 5, 5, 5, 7, 5, 5, 7, 5, 5, 7, 7, 5, 5, 5, 5, 7, 5, 6],
           [6, 5, 7, 7, 5, 5, 5, 7, 7, 5, 5, 5, 5, 5, 7, 5, 5, 5, 5, 6],
           [6, 7, 5, 7, 7, 5, 5, 5, 7, 5, 5, 5, 5, 5, 5, 5, 7, 5, 5, 6],
           [6, 5, 5, 5, 7, 5, 5, 5, 5, 7, 5, 7, 7, 5, 7, 5, 5, 5, 7, 6],
           [6, 7, 5, 5, 5, 5, 5, 7, 5, 5, 5, 5, 5, 5, 5, 5, 5, 5, 5, 6],
           [6, 5, 7, 5, 5, 7, 5, 5, 5, 5, 5, 5, 7, 5, 5, 7, 5, 5, 7, 6],
           [11, 9, 9, 9, 9, 9, 9, 9, 9, 9, 9, 9, 9, 9, 9, 9, 9, 9, 9, 1]
         ]
        },
        {
          "tiles":[
            [8, 9, 9, 9, 9, 9, 9, 9, 13, 5, 5, 3, 9, 9, 9, 9, 9, 9, 9, 4],
            [6, 12, 12, 12, 12, 12, 12, 12, 12, 7, 5, 12, 12, 12, 12, 12, 12, 12, 12, 6],
            [6, 7, 7, 5, 5, 7, 7, 5, 5, 5, 5, 7, 5, 7, 5, 5, 5, 5, 5, 6],
            [6, 7, 5, 5, 7, 5, 5, 5, 5, 5, 7, 5, 5, 5, 5, 5, 5, 5, 7, 6],
            [6, 5, 5, 5, 5, 5, 7, 5, 7, 5, 5, 7, 7, 7, 5, 5, 5, 5, 7, 6],
            [6, 5, 5, 5, 7, 5, 5, 5, 5, 5, 7, 5, 5, 5, 5, 7, 5, 5, 5, 6],
            [6, 5, 7, 5, 5, 7, 7, 5, 5, 7, 7, 5, 5, 5, 5, 7, 7, 7, 5, 6],
            [6, 5, 5, 5, 5, 5, 5, 7, 5, 5, 7, 5, 7, 5, 5, 5, 5, 7, 7, 6],
            [6, 5, 5, 7, 7, 5, 7, 5, 5, 7, 5, 5, 5, 5, 5, 5, 5, 5, 5, 6],
            [6, 5, 5, 5, 5, 7, 7, 7, 5, 5, 5, 7, 5, 5, 7, 7, 5, 5, 5, 6],
            [6, 7, 7, 5, 5, 5, 7, 7, 7, 7, 7, 5, 5, 5, 5, 5, 5, 5, 7, 6],
            [6, 5, 5, 5, 5, 7, 5, 5, 5, 5, 5, 5, 7, 5, 5, 5, 5, 5, 5, 6],
            [6, 7, 5, 7, 5, 7, 5, 5, 5, 5, 5, 7, 5, 5, 5, 5, 5, 5, 7, 6],
            [6, 5, 5, 7, 7, 7, 5, 5, 7, 5, 5, 5, 7, 5, 7, 7, 5, 5, 5, 6],
            [11, 9, 9, 9, 9, 9, 9, 9, 9, 9, 9, 9, 9, 9, 9, 9, 9, 9, 9, 1]
        ]
    }
]
}